




EA	./text/yellow_terracotta.xpm  
NO	./text/packed_ice.xpm   
SO	./text/honey_block_bottom.xpm		
WE ./text/bedrock.xpm

F 125,124,125				
C	120,206,235    

11111111111111111111111
10000100000000010001001
10111100111110011101001
100000001   10110001001
100000001   10011000001
100W0000111110000001101
10000100000000000010001
11111111111111111111111
